CCCCCEEEEEEEEEEEE
CCCCCEEEEEEEEEEEE
CCCCCEEEEEEEEEEEE
CCCCCEEEEEEEEWGWE
CCCCCWWWWWWWWWEWE
CCCCCEEEEEEEEEEWE
CCCCCWWWWWWWWWWWE
CCCCCEEEEEEEEEEEE
CCCCCEEEEEEEEEEEE
CCCCCEEEEEEEEEEEE
CCCCCEEEEEEEEEEEE
CCCCCEEEEEEEEEEEE