CCCCCEEEEEEEEEEEE
CCCCCEEEEEEEEEEEE
CCCCCEEEEEEEEEEEE
CCCCCEEEEEEEEEEEE
CCCCCWWWWWWWWWWWE
CCCCCEEEEEEEEGEEE
CCCCCWWWWWWWWWWWE
CCCCCEEEEEEEEEEEE
CCCCCEEEEEEEEEEEE
CCCCCEEEEEEEEEEEE
CCCCCEEEEEEEEEEEE
CCCCCEEEEEEEEEEEE