CCCCCEEEEEEEEEEEE
CCCCCEEEEEEEEEEEE
CCCCCEEEEEEEEEEEE
CCCCCEEEEEEEEEEEE
CCCCCWWWWWWWWWWEE
CCCCCEEEEEEEEGWEE
CCCCCWWWWWWWWWWEE
CCCCCEEEEEEEEEEEE
CCCCCEEEEEEEEEEEE
CCCCCEEEEEEEEEEEE
CCCCCEEEEEEEEEEEE
CCCCCEEEEEEEEEEEE