CCCCCEEEEEEEEEEEE
CCCCCEEEEEEEEEEEE
CCCCCEEEEEEEEEEEE
CCCCCEEEEEEEEEEEE
CCCCCWWWWWWWWWWEE
CCCCCEEEEEEEEEWEE
CCCCCWWWWWWWWEWEE
CCCCCEEEEEEEWGWEE
CCCCCEEEEEEEWWWEE
CCCCCEEEEEEEEEEEE
CCCCCEEEEEEEEEEEE
CCCCCEEEEEEEEEEEE